Never Dance Again - Battle Tapes Remix - Sunset Neon
Serenade - BANNERS
In My Head - Mike Shinoda
PUSH EM - GHENGAR
anemoia - Oliver Buckland
忘れじの言の葉 - 2022 - 未来古代楽団
WHAT ROBOTS NEED - hazama RUNWAY ver. - AWAAWA
ラブカ? - 柊キライ
Tot Musica (From "One Piece Film: Red") - AmaLee
Bad Apple!! - RichaadEB
アイオライト - Inori Minase
メフィスト - QUEEN BEE
ヤンキーダンス - Nanawoakari
At Atelier - FAKE TYPE.
Ogama - IruGuitar
Severed Ties - insaneintherainmusic
Duality - CthulhuSeeker
Destroy (feat. Goo Munday) - Sidewalks and Skeletons
The Conjurer - Insomnium
Enter One - Sol Seppy
With Her I Die - Poisonblack
I Follow Rivers - Marika Hackman
Intoxicate Me - Unlike Pluto
Talia - Chaz Duffy
Monster - YOASOBI
Monster Song (Demo) - Dom Fera
Miss You - Sped Up Version - southstar
Who's Counting - MGMT
KICK BACK - Kenshi Yonezu
Damned Le Monde - Zeromancer
Nightjar And The Nightingale - Roo Panes
I J u s t W a n t t o B e t h e O n e Y o u L o v e e e - DJ BYmoment
The Stranglings - Mr.Kitty Remix - Pure Obsessions & Red Nights
Meine - Daso
Be Quick or Be Dead - 2015 Remaster - Iron Maiden
Hunter’s Moon - Ghost
Time Is Up - Poppy
Leave It In My Dreams - The Voidz
Let’s Go - Stuck in the Sound
Melody Lane - Uncle Acid & The Deadbeats
Better Than Love - Hurts
Freaking Out The Neighborhood - Mac DeMarco
If You Can't Give Me Love - 2017 Remaster - Suzi Quatro
Phantasmagoria - Ashbury Heights
I Am Machine - Three Days Grace
maybe (feat. Bring Me The Horizon) - Machine Gun Kelly
Bad Day - Charlotte Sands
Flexin' - Laidback Luke
Down Under - Men At Work
Sadderdaze - The Neighbourhood
Basic Needs - Jonathan Davis
In the Way - Ithaca
List - Hey
The Perfect Girl - Mareux
NAJGORSZE RZECZY - WaluśKraksaKryzys
Play Destroy - Poppy
Voices - Disturbed
Addictive - Royal Republic
Stay With Me - Sam Smith
The Boards - The Motorleague
旅の途中 - 清浦夏実
Here 【TV-EDIT】 - JUNNA
Between Two Worlds - Mili
Hibiki - Akiko Shikata
だきしめるまで。 - MIMI
VIOLET - Ninomae Ina’nis
レクイエム - Kanaria
UNFORGIVEN - Japanese ver. - LE SSERAFIM
Radio Noise - ミコ吉
フールフールフール - おくのほそみち
リセットボタン - こはならむ
イイコと妖狐 - Kikuo
Hazy Skyscraper - DEMONDICE
L.L.L. - MYTH & ROID
Bulbel - Binary Haze Interactive
Remembrance - MYTH & ROID
トルキア - Gabriela Robin
Holy and Darkness 1 - arai tasuku
幽居のワルツ - Reol
Fallen Down - Duncan Cox
nothing but evil - Astrophysics
ローラー (from Raison d'être) - Kairikibear
ヒトガワリ - きくおはな
Classroom of The Elite (PACT) - 赤い神Enryu
Tower Of God Epic Medley: Ignition / Guardian / Berserker Bam - Max Shirshov
asphyxia - Cö shu Nie
GLASSY SKY - Yutaka Yamada
踊 - Ado
色彩 - yama
MoonWalker - yama
Where Are the Birds - Good Tiger
Well Off - Former Vandal
It's Cool - New Beat Fund
Straight to My Head - You Me At Six
Catastrophic - Olen
Superstar - Twin Wild
2AM - Bear Hands
Fake Love - Cemetery Sun
Lazy Minds - Mo Lowda & the Humble
Call My Name - The Unlikely Candidates
